                           ****        *        *         ****
                       ****************************   *** **** **  **   *****
                    *******************************************************
                     ****************************************************
                    ***************************************************
                      ***********************************************
                           *****************************************
                            ************************************////
                             **********************************////
                            ********************************///// 
                            *******************************/////
                            *******************************////
                             *******************************///
                            *********************************////
                              *******************************///
                            ***********************************
                              ******************************
                             *****************************
                               **   *******************
                                     *******
                                      **** ?