                           ****        *        *         ****
                       ****************************   *** **** **  **   *****
                    *******************************************************
                     ****************************************************
                    ***************************************************
                      ***********************************************
                           *****************************************
                            ****************************************
                             **************************************
                            *************************************
                            ************************************
                            ***********************************
                             **********************************
                            *************************************
                              **********************************
                            ********///////*******///////******
                              ///////////////////////////////////
                             //////////////////////////////////
                               //   /////////////////////
                                     ///////
                                      //// ?