                           ****        *        *         ****
                       ****************************   *** **** **  **   *****
                    *******************************************************
                     ****************************************************
                    ***************************************************
                      ***********************************************
                           *****************************************
                            *****************///********************
                             ***************/////******************
                            ***************//////****************
                            *******************//***************
                            ***********************************
                             **********************************
                            *************************************
                              **********************************
                            ***********************************
                              ******************************
                             *****************************
                               **   *******************
                                     *******
                                      **** ?