                           ****        *        *         ****
                       ****************************   *** **** //  //   /////
                    ******************************************//////////////
                     ********************************************/////////
                    *********************************************//////
                      *******************************************////
                           **************************************///
                            ****************************************
                             **************************************
                            *************************************
                            ************************************
                            ***********************************
                             **********************************
                            *************************************
                              **********************************
                            ***********************************
                              ******************************
                             *****************************
                               **   *******************
                                     *******
                                      **** ?